// Map-design
000000001000
000000001000
000000001000
000000001000
000000001000
000000001000
000000001000
000000001000
000000001000
000000001110
000000000010
000000000090
// Map activity
01010101010101