// Map-design
000001000000
003001000000
000001111111
000300003031
030000300001
000000000001
000011111101
000013000101
000311110101
000000310101
011111110131
093000000111
// Map activity
111111111111111111